1946	e l e f tS a m e o t a R b a i m v e S e S
1961	e l e f tS a m e o t S i S i m v e a X a t
1967	e l e f tS a m e o t S i S i m v e S e v a
1968	e l e f tS a m e o t S i S i m v e S m o n e
2001	a l p a i m v e a X a t
2004	a l p a i m v e a R b a
2005	a l p a I m v e X a m e S
2006	a l p a i m v e S e S
2008	a l p a i m v e S m o n e
2009	a l p a i m v e t e j S a
2010	a l p a i m v e ? e s e R
2011	a l p a i m v e a X a t e s R e
2012	a l p a i m v e S t e m e s R e
2013	a l p a i m v e S l o S e s R e
2014	a l p a i m v e a R b a e s R e
2016	a l p a i m v e S e S e s R e
2017	a l p a i m v e S v a e s R e
2018	a l p a i m v e S m o n a e s R e
2019	a l p a i m v e tS a e s R e
2020	a l p a i m v e ? e s R i m
2021	a l p a i m e s R i m v e a X a t
2022	a l p a i m e s R i m v e S t a i m
2025	a l p a i m e s R i m v e X a m e S
2030	a l p a i m S l o S i m
4000	a R b a t a l a f i m
%	a X u z
א'	a l e f
אֲבָל	a v a l
אֲחֵרִים	a X e R i m
אֲנִי	a n i
אֲנַחְנוּ	a n a X n u
אֲנָשִׁים	a n a S i m
אֲפִילּוּ	a f i l u
אִם	i m
אֵיזֶה	e j z e
אֵיךְ	e X
אֵין	e j n
אֵלֶּה	e l e
אֶחָד	e X a d
אֶלָּא	e l a
אֶפְשָׁר	e f S a R
אֶת	e t
אַחֲרֵי	a X a R e j
אַחַת	a X a t
אַלוֹבִיץ'	a l o v i tS
אַתֶּם	a t e m
אַתָּה	a t a
אָז	a z
אברהם	a v R a h a m
אדג'	e dZ
אה	e
אהה	e
אהמ	SPN
אהם	e h m
אוֹ	o
אוֹמֵר	o m e R
אוֹקֵיי	o k e j
אוֹתָם	o t a m
אוֹתוֹ	o t o
אוּלַי	u l a j
אוגוסט	o g u s t
אול	o l
אייפון	a j f o n
איל"ן	i l a n
אינפלציה	i n f l a ts i j a
אכפת	e X p a t
אלוביץ'	a l o v i tS
אממ	e m
אמסטרדמסקי	a m s t e R d a m s k i
אני	a n i
אפסטור	a p s t o R
ארה"ב	a R ts o t a b R i t
אש"ף	a S a f
אתה	a t a
אתם	a t e m
אתן	a t e n
ב'	b e t
בְּאוֹפֶן	b e o f e n
בְּדִיּוּק	b i d i j u k
בְּיִשְׂרָאֵל	b e i s R a e l
בְּכָל	b e X o l
בְּעֶצֶם	b e ? e ts e m
בִּגְלַל	b i g l a l
בִּכְלָל	b i X l a l
בִּשְׁבִיל	b i S v i l
בֵּין	b e j n
בֶּאֱמֶת	b e e m e t
בּוֹגִ'י	b o dZ i
בּוֹזִ'י	b o Z i
ב2000	b e a l p a i m
ב2004	b e a l p a i m v e a R b a
ב2008	b e a l p a i m v e S m o n e
ב2010	b e a l p a i m v e ? e s e R
באינפלציה	b e i n f l a ts i j a
באפסטור	b e a p s t o R
בארה"ב	b e a R ts o t a b R i t
בבקשה	b e v a k a S a
בוואטסאפ	b e w o ts a p
בוואלה	b e w a l a
בוויינט	b e w a j n e t
בוול	b e w o l
בטוויטר	b i t w i t e R
בירושלים	b e j e R u S a l a i m
בכל	b e X o l
במילא	b e m e j l e
בתחרות	b a t a X a R u t
ג'אנק	dZ a n k
ג'וֹ	dZ o
ג'ורנל	dZ o R n a l
ג'יפי	dZ i p i
גִ'ים	dZ i m
גַּם	g a m
גָּדוֹל	g a d o l
גאידסטאר	g a j d s t a R
גידהר	g i d h a R
דְּבָרִים	d v a R i m
דָּבָר	d a v a R
דה	d e
דו"ח	d u a X
דיסקליימר	d i s k l e j m e R
דיפיוז'ן	d i f j u Z e n
דפלציה	d i f l a ts i j a
הֲכִי	a X i
הִיא	i
הִנֵּה	h i n e
הֵם	e m
הַאִם	a i m
הַבְּרִית	a b R i t
הַזֶּה	a z e
הַזֹּאת	a z o t
הַזּוֹ	a z o
הַחוֹלִים	a X o l i m
הַיּוֹם	a j o m
הַכֶּסֶף	a k e s e f
הַכֹּל	a k o l
הַמֶּמְשָׁלָה	a m e m S a l a
הַפֶּרֶק	a p e R e k
הַצֵּ'קִים	a tS e k i m
הַקּוֹטֵג'	a k o t e dZ
הַרְבֵּה	a R b e
הָאֵלֶּה	a e l e
הָיְיתָה	a j t a
הָיָה	a j a
הָיוּ	a j u
הָמוֹן	a m o n
הָעוֹלָם	a o l a m
האזנתם	h e e z a n t e m
האזנתן	h e e z a n t e n
האינפלציה	a i n f l a ts i j a
הארוורד	h a R w a R d
הדו"ח	a d u a X
הוּא	u
הוואטסאפים	a w a ts a p i m
הווטסאפ	a w a ts a p
הולדרס	h o l d e R s
החבר'ה	a X e v R e
הי	h e j
היו"ר	a j o R
היי	h e j
הלואו	a l o u
הממ	e m
הממשלה	a m e m S a l a
המנכ"ל	a m a n k a l
המנכ"לים	a m a n k a l i m
המסנג'ר	a m e s e n dZ e R
הנדל"ן	a n a d l a n
הצ'אטבוטים	a tS e t b o t i m
הקטש	a k e tS
הרוחות	a R u X o t
השיוו	a S i v u
התמנפות	i t m a n f u t
וְאִם	v e i m
וְאָז	v e a z
וְגִ'י	v e dZ i
וְגַם	v e g a m
וְזֶה	v e z e
וְכוּ'	v e X u l e j
וְלָכֵן	v e l a X e n
וְלֹא	v e l o
ובוואלה	v e b e w a l a
ובכל	v e b e X o l
וג'ינס	v e dZ i n s
והאינפלציה	v e a i n f l a ts i j a
והמשקיעות	v e a m a S k i o t
וואטאבר	w o t e v e R
וואטסאפ	w o ts a p
וואי	w a j
וואלה	w a l a
וואן	w a n
וורטון	w o R t o n
וכשהאינפלציה	u X S e a i n f l a ts i j a
ולמטפלים	v e l e m e t a p l i m
ז'וּם	Z u m
זְ'קִים	Z e k i m
זְמַן	z m a n
זֶה	z e
זֹאת	z o t
זוֹ	z o
ח'	X e t
חֵלֶק	X e l e k
חֶבְרֶ'ה	X e v R e
חַיּוֹת	X a j o t
חבר'ה	X e v R e
חוֹשֵׁב	X o S e v
חוּגָ'ה	X u dZ a
חוּזָ'ה	X u Z a
חיות	X a j o t
חמיס	X a m i s
טוֹב	t o v
יְכוֹלִים	j e X o l i m
יִהְיֶה	i j e
יִשְׂרָאֵל	i s R a e l
יֵשׁ	j e S
יָכוֹל	j a X o l
יאללה	j a l a
יגווע	i g v a
יוֹדְעִים	j o d ? i m
יוֹדֵעַ	j o d e a
יוֹתֵר	j o t e R
יודע	j o d e a
כְּאִילּוּ	k i ? i l u
כְּבָר	k v a R
כְּלוֹמַר	k l o m a R
כְּמוֹ	k m o
כִּי	k i
כִּיס	k i s
כֵּן	k e n
כֶּסֶף	k e s e f
כַּמָּה	k a m a
כָּאֵלֶּה	k a e l e
כָּאן	k a n
כָּזֶה	k a z e
כָּךְ	k a X
כָּכָה	k a X a
כָּל	k o l
כיס	k i s
כמנכ"ל	k e m a n k a l
כש	k S e
כשאתה	k S e a t a
כשהאינפלציה	k S e a i n f l a ts i j a
לְזֶה	l e z e
לְמָשָׁל	l e m a S a l
לְפִי	l e f i
לְפָחוֹת	l e f a X o t
לִהְיוֹת	l i j o t
לִי	l i
לִפְנֵי	l i f n e j
לַעֲשׂוֹת	l a ? a s o t
לָהֶם	l a h e m
לָהּ	l a
לָכֶם	l a X e m
לָמָּה	l a m a
לָנוּ	l a n u
לֹא	l o
לא	l o
לאינפלציה	l a i n f l a ts i j a
לאלוביץ'	l e a l o v i tS
לארה"ב	l e a R ts o t a b R i t
לה	l a
להבין	l e a v i n
לוֹ	l o
לוואלה	l e w a l a
לטוויטר	l e t w i t e R
מְאוֹד	m e o d
מִזֶּה	m i z e
מִי	m i
מִינֵי	m i n e j
מַמָּשׁ	m a m a S
מַשֶּׁהוּ	m a S e u
מָה	m a
מאזינות	m a a z i n o t
מאזינים	m a a z i n i m
מאינפלציה	m e i n f l a ts i j a
מאלוביץ'	m e a l o v i tS
מאלפיים	m e a l p a i m
מגיע	m a g i a
מה	m a
מהאלוביצ'ים	m e h a a l o v i tS i m
מוואלה	m i w a l a
מזכ"ל	m a z k a l
מזכ"לית	m a z k a l i t
מחו"ל	m i X u l
מילא	m e j l e
מכיוון	m i k e j v a n
מכירים	m e k i R i m
מנכ'ל	m a n k a l
מנכ"ל	m a n k a l
מנכ"לי	m a n k a l e j
מנכ"ליות	m a n k a l i j o t
מנכ"לים	m a n k a l i m
מסועפת	m e s u e f e t
מצע	m a ts a
משמעותית	m a S m a u t i t
מעוניין	m e u n j a n
מעניין	m e a n j e n
נָכוֹן	n a X o n
סמוטריץ	s m o t R i tS
סמוטריץ'	s m o t R i tS
עֲדַיִין	a d a i n
עִם	i m
עַד	a d
עַכְשָׁיו	a X S a v
עַל	a l
עוֹד	o d
עמנואל	e m a n u e l
פְּרוֹפ'	p R o f e s o R
פַּעַם	p a ? a m
פָּחוֹת	p a X o t
פָּשׁוּט	p a S u t
פֹּה	p o
פטרושקה	p a t R u S k a
פסיקות	p s i k o t
פרופ'	p R o f e s o R
פתרון	p i t a R o n
צ'אטבוטים	tS e t b o t i m
צ'ט	tS e t
צ'קאאוטס	tS e k a u t
צְ'קִים	tS e k i m
צְרִיז'ִים	ts R i Z i m
צְרִיכִים	ts R i X i m
צֵ'ק	tS e k
צָרִיךְ	ts a R i X
צליל	ts l i l
קְצָת	k ts a t
קאצ'	k e tS
קוו	k v o
קונסולטינג	k o n s o l t i n g
רֶגַע	R e g a
רַבָּה	R a b a
רַק	R a k
רֹאשׁ	R o S
רוֹצִים	R o ts i m
רוֹצֶה	R o ts e
רובו	R o b o
רובושאול	R o b o S a u l
שְׁנִיָּיה	S n i j a
שְׁקָלִים	S k a l i m
שֶׁאֲנִי	S e a n i
שֶׁאֲנַחְנוּ	S e a n a X n u
שֶׁאַתֶּם	S e a t e m
שֶׁהִיא	S e h i
שֶׁהֵם	S e h e m
שֶׁהוּא	S e u
שֶׁזֶּה	S e z e
שֶׁיֵּשׁ	S e j e S
שֶׁל	S e l
שֶׁלִּי	S e l i
שֶׁלָּהֶם	S e l a e m
שֶׁלָּהּ	S e l a
שֶׁלָּכֶם	S e l a X e m
שֶׁלָּנוּ	S e l a n u
שֶׁלֹּא	S e l o
שֶׁלּוֹ	S e l o
שָׁאוּל	S a u l
שָׁם	S a m
שָׁנִים	S a n i m
שָׁנָה	S a n a
שׁוּב	S u v
שׁוּם	S u m
שאול	S a u l
שאינפלציה	S e i n f l a ts i j a
שאלוביץ'	S e a l o v i tS
שהאינפלציה	S e a i n f l a ts i j a
שהאלוביצ'ים	S e h a a l o v i tS i m
שהדוח	S e a d u a X
שייר	S e R
שסופרמרקטים	S e s u p e R m a R k e t i m
תּוֹדָה	t o d a
תוריד	t o R i d
תחרות	t a X a R u t
תיקו	t e k o
תנ"ך	t a n a X
תנ"כית	t a n a X i t
